0 0 0 0 0 0 0 0 0 0 0 0 0
0 1 1 1 1 1 1 1 1 1 1 1 0
0 0 0 0 0 1 1 1 0 0 0 0 0
0 14 14 14 0 0 1 0 0 14 14 14 0
0 1 15 1 19 1 32 1 19 1 15 1 0
0 0 0 0 0 1 1 1 0 0 0 0 0
0 14 8 14 0 0 1 0 0 14 7 14 0
0 1 15 1 0 0 1 0 0 1 15 1 0
0 1 1 1 0 0 1 0 0 1 1 1 0
0 16 0 16 0 0 18 0 0 16 0 16 0
0 1 0 1 0 1 1 1 0 1 0 1 0
0 26 0 1 13 1 1 1 13 1 0 6 0
0 0 0 0 0 0 0 0 0 0 0 0 0