0 0 0 0 0 0 0 0 0 0 0 0 0
0 2 1 3 4 3 1 1 1 1 1 1 0
0 0 0 0 0 0 0 0 0 0 0 1 0
0 5 1 1 16 1 0 7 9 1 0 1 0
0 1 14 1 0 1 0 8 5 1 0 1 0
0 0 16 0 0 1 0 0 0 16 0 1 0
0 9 1 1 0 1 16 12 13 12 0 1 0
0 1 15 1 0 1 0 0 0 0 0 1 0
0 0 16 0 0 1 1 1 1 1 1 1 0
0 1 1 1 0 0 16 0 0 0 16 0 0
0 5 1 9 0 9 1 1 0 1 12 1 0
0 5 1 9 0 1 1 1 0 3 6 3 0
0 0 0 0 0 0 0 0 0 0 0 0 0