0 0 0 0 0 0 0 0 0 0 0 0 0
0 26 1 17 1 1 1 1 1 1 1 1 0
0 1 1 0 0 1 24 1 24 1 0 0 0
0 1 0 0 0 0 0 1 0 0 0 0 0
0 1 0 9 9 0 1 1 1 0 1 20 0
0 1 0 9 1 25 1 1 1 25 1 1 0
0 1 0 0 0 0 1 1 1 0 0 0 0
0 1 0 27 1 0 1 1 1 0 1 21 0
0 1 0 1 1 25 1 1 1 25 1 1 0
0 1 0 0 0 0 1 1 1 0 0 0 0
0 1 0 6 6 0 1 1 1 0 1 1 0
0 2 0 6 1 25 1 1 1 25 1 1 0
0 0 0 0 0 0 0 0 0 0 0 0 0