0 0 0 0 0 0 0 0 0 0 0 0 0
0 9 8 0 9 6 9 0 1 0 1 5 0
0 1 5 0 6 9 6 0 1 16 12 1 0
0 13 1 0 9 10 9 0 1 0 0 0 0
0 16 0 0 0 1 0 0 1 0 1 20 0
0 1 1 12 1 1 1 3 1 1 1 1 0
0 16 0 0 1 1 1 0 1 0 0 0 0
0 14 1 0 0 1 0 0 1 0 1 5 0
0 1 9 0 1 1 1 0 1 16 13 9 0
0 5 7 0 1 1 1 0 1 0 0 0 0
0 0 0 0 0 1 0 0 4 0 1 1 0
0 26 1 1 1 1 1 0 1 16 1 2 0
0 0 0 0 0 0 0 0 0 0 0 0 0