0 0 0 0 0 0 0 0 0 0 0 0 0
0 1 10 1 0 22 29 29 0 1 20 1 0
0 5 1 9 0 1 1 1 0 9 1 6 0
0 1 1 1 0 1 1 1 0 1 15 1 0
0 0 16 0 0 0 17 0 0 0 16 0 0
0 1 13 1 16 1 4 1 1 14 1 1 0
0 1 1 1 0 0 0 0 0 0 0 0 0
0 4 1 3 1 1 1 1 1 1 1 1 0
0 16 0 0 16 0 0 0 16 0 0 16 0
0 1 0 1 12 1 0 1 13 1 0 1 0
0 1 0 3 1 9 0 7 1 5 0 1 0
0 2 0 9 3 9 0 1 3 1 0 26 0
0 0 0 0 0 0 0 0 0 0 0 0 0