0 0 0 0 0 0 0 0 0 0 0 0 0
0 2 0 1 4 16 1 0 1 1 16 1 0
0 1 0 1 1 0 9 0 3 3 0 4 0
0 1 16 12 1 0 1 0 9 9 0 1 0
0 0 0 0 16 0 12 0 9 9 0 1 0
0 9 1 13 1 0 1 0 0 0 0 1 0
0 9 1 1 12 0 1 3 1 1 1 1 0
0 0 15 0 0 0 1 0 0 0 0 4 0
0 1 1 1 1 0 3 0 1 1 1 1 0
0 8 9 5 1 0 1 0 9 0 0 0 0
0 0 0 0 0 0 1 0 1 0 1 1 0
0 26 1 1 1 1 1 0 1 28 1 30
0 0 0 0 0 0 0 0 0 0 0 0 0