0 0 0 0 0 0 0 0 0 0 0 0 0
0 26 0 9 9 0 1 13 1 9 3 1 0
0 1 0 9 9 0 1 0 0 0 0 16 0
0 1 0 0 4 0 1 0 5 1 14 1 0
0 1 16 16 1 16 1 0 21 1 1 12 0
0 1 0 0 0 0 1 0 0 0 0 0 0
0 1 1 4 13 1 9 1 14 15 1 1 0
0 0 0 0 0 0 1 0 0 0 0 1 0
0 13 1 1 20 0 1 16 16 1 16 1 0
0 1 12 1 8 0 1 0 0 4 0 4 0
0 16 0 0 0 0 1 0 1 1 0 1 0
0 1 3 1 1 14 1 0 5 5 0 2 0
0 0 0 0 0 0 0 0 0 0 0 0 0