0 0 0 0 0 0 0 0 0 0 0 0 0
0 2 0 7 0 1 21 1 0 9 0 3 0
0 1 0 5 0 1 1 1 0 9 0 4 0
0 1 0 12 0 4 0 15 0 5 0 3 0
0 1 0 1 0 1 0 1 0 1 0 1 0
0 16 0 16 0 17 0 16 0 14 0 16 0
0 1 15 1 13 1 1 1 1 1 1 1 0
0 16 0 16 0 16 0 16 0 15 0 16 0
0 1 0 1 0 1 0 1 0 1 0 1 0
0 1 0 1 0 12 0 4 0 6 0 1 0
0 3 0 3 0 9 0 13 0 9 0 1 0
0 1 4 1 0 9 0 6 0 9 0 26 0
0 0 0 0 0 0 0 0 0 0 0 0 0