0 0 0 0 0 0 0 0 0 0 0 0 0
0 26 1 16 16 1 2 1 0 9 1 9 0
0 1 1 0 0 1 1 3 0 1 11 1 0
0 16 0 0 0 0 16 0 0 6 1 5 0
0 1 0 9 9 9 1 1 0 0 19 0 0
0 5 0 0 0 0 0 13 0 23 1 23 0
0 1 4 3 4 1 0 1 0 1 1 1 0
0 0 0 0 0 16 0 12 0 0 16 0 0
0 1 1 1 12 1 14 1 13 1 1 1 0
0 16 0 0 0 0 0 0 0 0 0 16 0
0 3 1 0 7 9 0 10 5 0 1 14 0
0 1 12 17 9 8 0 9 1 16 15 1 0
0 0 0 0 0 0 0 0 0 0 0 0 0