0 0 0 0 0 0 0 0 0 0 0 0 0
0 1 1 14 16 1 26 1 16 3 1 5 0
0 1 9 1 0 1 1 1 0 1 3 1 0
0 15 0 0 0 0 17 0 0 0 0 1 0
0 1 9 1 0 9 1 9 16 16 1 1 0
0 8 1 12 16 1 7 1 0 0 28 0 0
0 0 0 0 0 0 0 4 0 1 1 15 0
0 9 1 16 15 9 0 1 0 31 0 1 0
0 15 1 0 1 1 0 1 0 0 0 16 0
0 16 0 0 0 16 0 1 0 9 1 13 0
0 1 5 0 1 14 0 12 0 1 14 1 0
0 2 1 17 1 1 16 1 16 13 1 5 0
0 0 0 0 0 0 0 0 0 0 0 0 0